luu_thanhcong=Lưu phiếu nhập thành công
luu_khongthanhcong=Lưu phiếu nhập không thành công, vui lòng thử lại
sophieu=Số phiếu
ngaylapphieu=Ngày lập phiếu
ngaynhapkho=Ngày nhập kho
taikho=Tại kho
ma_ncc=Mã Nhà Cung Cấp
ncc=Nhà cung cấp
ng_lienhe=Người liên hệ
nguoigiao=N.Giao
hopdong=Hợp đồng
dondathang=Đơn đặt hàng
thanhtien=Thành tiền
tienvat=Tiền VAT
giasauthue=Giá sau thuế
sohd=Số HĐ
ngayhd=Ngày HĐ
tungay=Từ ngày
denngay=Đến ngày
tuso=Từ số
denso=Đến số
ma_kh=Mã khách hàng
makho=Mã kho
mathuoc=Mã thuốc
timkiem_thuoc_vtyt=Tìm Kiếm Thuốc Vật Tư Y Tế
tim_ncc=Tìm Nhà Cung Cấp
loi=Lỗi
dl_khongdung=Dữ liệu nhập vào không đúng
ma=Mã
nglapphieu=Người lập phiếu
ngaylap=Ngày lập
ngaynhap=Ngày nhập
ngduyet=Người duyệt
ngayduyet=Ngày duyệt
kho=Kho
loainhap=Loại nhập
dondathang=Đ.đặt hàng
hopdong=Hợp đồng
phieunhap=Phiếu nhập

them=Thêm mới
sua=Sửa
chonphieu=Vui lòng chọn phiếu
chondong=Vui lòng chọn một dòng
xoa=Xóa
refresh=Tải lại
duyet=Duyệt
timkiem=Tìm kiếm
in=In
xem=Xuất Excel
dong=Đóng
luu=Lưu
mathuoc=Mã Thuốc
tenbietduoc=Tên biệt dược
dvt=ĐVT
lo_noibo=Lô nội bộ
lo_nsx=Lô NXS
soluong=S.lượng
dongia=Đ.giá
ngaySX=N.sản xuất
ngayHH=N.hết hạn
chitietnhap=Chi tiết nhập
tennhomthuoc=Tên nhóm thuốc
dm_thuoc_vtyt=Danh mục thuốc và vật tư y tế
dm_ncc=Danh mục nhà cung cấp
canhbao=Cảnh báo
chitiet_canhbao=Bạn đã thay đổi nội dung, bạn có muốn lưu lại dữ liệu trước khi thoát hay không?